<s>	silb	
[noise](+inhale+)	+inhale+	
[begin_noise]	sil	
but(2)	b(sil,ax)b	ax(b,td)	td(ax,sil)e	
[end_noise]	sil	
turn	t(sil,er)b	er(t,n)	n(er,ah)e	
upside	ah	p	s	ay(s,dd)	dd(ay,d)e	
down	d(dd,aw)b	aw(d,n)	n(aw,ae)e	
/ae	ae	
n/	n(ae,sil)e	
sil	sil	
its(2)	ix(sil,ts)b	ts(ix,k)e	
colors	k(ts,ah)b	ah(k,l)	l	axr(l,z)	z(axr,aa)e	
are	aa(z,r)b	r(aa,b)e	
brown	b(r,r)b	r(b,aw)	aw(r,n)	n(aw,sil)e	
[human_noise](+rustle+)	+rustle+	
sil	sil	
black	b(sil,l)b	l(b,ae)	ae	kd(ae,sil)e	
[begin_noise]	sil	
pale	p(sil,ey)b	ey(p,l)	l(ey,sil)e	
[end_noise]	sil	
yellow	y(sil,eh)b	eh	l(eh,ow)	ow(l,ao)e	
or	ao(ow,r)b	r(ao,w)e	
white(2)	w(r,ay)b	ay	td(ay,sil)e	
[noise](+smack+)	+smack+	
sil	sil	
[sil]	sil	
</s>	sile	
