<s>	silb	
[begin_noise]	sil	
/ey/	ey(sil,sil)s	
[end_noise]	sil	
keep	k(sil,iy)b	iy(k,pd)	pd(iy,dh)e	
the(3)	dh(pd,iy)b	iy(dh,eh)e	
eggs	eh(iy,g)b	g(eh,z)	z(g,w)e	
warm	w(z,ao)b	ao(w,r)	r(ao,m)	m(r,ax)e	
until	ax(m,n)b	n(ax,t)	t(n,ih)	ih(t,l)	l(ih,dh)e	
the	dh(l,ah)b	ah(dh,b)e	
baby	b(ah,ey)b	ey	b(ey,iy)	iy(b,p)e	
penguins	p(iy,eh)b	eh	ng	g	w	ax(w,n)	n(ax,z)	z(n,b)e	
break	b(z,r)b	r(b,ey)	ey(r,kd)	kd(ey,aw)e	
out	aw(kd,td)b	td(aw,ax)e	
of(2)	ax(td,v)b	v(ax,dh)e	
the(3)	dh(v,iy)b	iy(dh,eh)e	
eggs	eh(iy,g)b	g(eh,z)	z(g,sil)e	
sil	sil	
[sil]	sil	
sil	sil	
</s>	sile	
