<s>	silb	
sil	sil	
out	aw(sil,td)b	td(aw,ax)e	
of(2)	ax(td,v)b	v(ax,dh)e	
the(2)	dh(v,ax)b	ax(dh,w)e	
water	w(ax,ao)b	ao(w,dx)	dx(ao,axr)	axr(dx,sil)e	
[begin_noise]	sil	
penguins	p(sil,eh)b	eh	ng	g	w	ax(w,n)	n(ax,z)	z(n,sil)e	
[end_noise]	sil	
must	m(sil,ah)b	ah(m,s)	s(ah,td)	td(s,w)e	
/w	w	
eh/	eh	
sil	sil	
waddle	w	aa(w,dx)	dx(aa,ax)	ax(dx,l)	l(ax,sil)e	
sil	sil	
and(2)	ax(sil,n)b	n(ax,dd)	dd(n,hh)e	
hop	hh(dd,aa)b	aa	pd	
across	ax(pd,k)b	k(ax,r)	r(k,ao)	ao(r,s)	s(ao,dh)e	
the(2)	dh(s,ax)b	ax(dh,ay)e	
ice	ay	s(ay,sil)e	
[sil]	sil	
</s>	sile	
