<s>	silb	
[noise]	sil	
they	dh(sil,ey)b	ey(dh,b)e	
blow	b(ey,l)b	l(b,ow)	ow(l,ey)e	
a(2)	ey(ow,l)s	
long	l(ey,ao)b	ao(l,ng)	ng(ao,sil)e	
[begin_noise]	sil	
thin	th(sil,ih)b	ih(th,n)	n(ih,k)e	
cloud	k(n,l)b	l	aw(l,dd)	dd(aw,d)e	
down	d(dd,aw)b	aw(d,n)	n(aw,sil)e	
[end_noise]	sil	
to(3)	t(sil,uw)b	uw(t,dh)e	
the	dh(uw,ah)b	ah(dh,g)e	
/g	g	
r(/r/)	r(g,aw)	
aw(/aw/)	aw(r,n)e	
n/	n(aw,sil)e	
sil	sil	
[noise]	sil	
</s>	sile	
