<s>	silb	
[noise](+inhale+)	+inhale+	
sil	sil	
storms	s(sil,t)b	t(s,ao)	ao(t,r)	r(ao,m)	m	z(m,sil)e	
sil	sil	
in(2)	ix(sil,n)b	n(ix,dh)e	
the	dh(n,ah)b	ah(dh,s)e	
spring	s(ah,p)b	p(s,r)	r(p,ih)	ih(r,ng)	ng(ih,sil)e	
sil	sil	
can	k(sil,ae)b	ae(k,n)	n(ae,b)e	
bring	b(n,r)b	r(b,ih)	ih(r,ng)	ng(ih,sil)e	
[begin_noise]	sil	
/l	l	
ay	ay(l,sil)s	
sil	sil	
n(/n/)	n	
iy(/iy/)	iy(n,sil)e	
ng/	ng	
[end_noise]	sil	
</s>	sile	
