<s>	silb	
schools	s(sil,k)b	k(s,uw)	uw(k,l)	l	z(l,ih)e	
in	ih(z,n)b	n(ih,r)e	
rwanda	r(n,ax)	ax	w(ax,aa)	aa(w,n)	n	d(n,ax)	ax	
did	d(ax,ih)b	ih(d,dd)	dd(ih,sil)e	
[begin_noise]	sil	
not	n	aa	td	
have	hh(td,ae)b	ae(hh,v)	v(ae,sil)e	
[end_noise]	sil	
room	r(sil,uw)b	uw(r,m)	m(uw,f)e	
for(2)	f(m,axr)b	axr(f,sil)e	
[human_noise](+inhale+)	+inhale+	
sil	sil	
all	ao(sil,l)b	l(ao,dh)e	
the(2)	dh(l,ax)b	ax(dh,sil)e	
[begin_noise]	sil	
children	ch(sil,ih)b	ih(ch,l)	l(ih,d)	d(l,r)	r(d,ax)	ax(r,n)	n(ax,sil)e	
[end_noise]	sil	
[noise](+exhale+)	+exhale+	
</s>	sile	
