<s>	silb	
sil	sil	
the(2)	dh(sil,ax)b	ax(dh,f)e	
first	f(ax,er)b	er(f,s)	s(er,td)	td(s,th)e	
thing	th(td,ih)b	ih(th,ng)	ng(ih,dh)e	
the(3)	dh(ng,iy)b	iy(dh,k)e	
caterpillar(2)	k(iy,ae)b	ae(k,dx)	dx(ae,axr)	axr	p	ih	l	axr(l,sil)e	
sil	sil	
eats	iy	ts(iy,sil)e	
sil	sil	
is(2)	ix(sil,z)b	z(ix,sil)e	
[noise](+inhale+)	+inhale+	
sil	sil	
its	ih(sil,ts)b	ts(ih,ow)e	
own	ow(ts,n)b	n(ow,sil)e	
sil	sil	
/eh	eh	
g(/g/)	g	
sh(/sh/)	sh	
ax/	ax(sh,sil)s	
[sil]	sil	
</s>	sile	
