<s>	silb	
sil	sil	
now	n(sil,aw)b	aw(n,ey)e	
a(2)	ey(aw,l)s	
lot(2)	l(ey,ao)b	ao(l,td)	td(ao,m)e	
more	m(td,ao)b	ao(m,r)	r(ao,p)e	
people	p(r,iy)b	iy(p,p)	p(iy,ax)	ax(p,l)	l(ax,r)e	
recycle	r(l,iy)b	iy(r,s)	s(iy,ay)	ay	k	ax(k,l)	l(ax,k)e	
cans	k(l,ae)b	ae(k,n)	n(ae,z)	z(n,sil)e	
sil	sil	
[human_noise]	sil	
bottles	b	aa	dx(aa,ax)	ax(dx,l)	l(ax,z)	z(l,ae)e	
and	ae(z,n)b	n(ae,dd)	dd(n,p)e	
/p	p	
ey(/ey/)	ey(p,sil)e	
sil	sil	
p(/p/)	p	
ah/	ah	
sil	sil	
</s>	sile	
