<s>	silb	
[noise]	sil	
they	dh(sil,ey)b	ey(dh,sil)e	
sil	sil	
[sil]	sil	
are	aa(sil,r)b	r(aa,sil)e	
[noise](+noise+)	+noise+	
finding	f(sil,ay)b	ay(f,n)	n(ay,d)	d(n,ix)	ix(d,ng)	ng(ix,n)e	
new(2)	n(ng,y)b	y(n,uw)	uw(y,sil)e	
[begin_noise]	sil	
plants	p(sil,l)b	l(p,ae)	ae(l,n)	n	ts(n,sil)e	
[end_noise]	sil	
/ae	ae	
n/	n(ae,ae)e	
animals	ae(n,n)b	n(ae,ax)	ax(n,m)	m(ax,ax)	ax(m,l)	l(ax,z)	z(l,dh)e	
that	dh(z,ae)b	ae(dh,td)	td(ae,l)e	
live(2)	l(td,ih)b	ih(l,v)	v(ih,sil)e	
sil	sil	
in(2)	ix(sil,n)b	n(ix,dh)e	
the	dh(n,ah)b	ah(dh,sil)e	
[sil]	sil	
tall	t(sil,ao)b	ao	l(ao,t)e	
/t	t	
r(/r/)	r(t,iy)	
iy(/iy/)	iy(r,t)e	
t(/t/)	t	
aa(/aa/)	aa(t,p)e	
p(/p/)	p	
s/	s(p,sil)e	
[noise]	sil	
[sil]	sil	
</s>	sile	
