<s>	silb	
[noise](+inhale+)	+inhale+	
sil	sil	
now	n(sil,aw)b	aw(n,dh)e	
they	dh(aw,ey)b	ey(dh,y)e	
use(2)	y(ey,uw)b	uw(y,z)	z(uw,sil)e	
sil	sil	
walkways	w(sil,ao)b	ao(w,k)	k	w	ey(w,z)	z(ey,sil)e	
[human_noise](+inhale+)	+inhale+	
sil	sil	
/d	d	
ae(/ae/)	ae	
t/	t	
/hh	hh	
ah	aa(hh,sil)e	
ng/	ng	
sil	sil	
[human_noise](+inhale+)	+inhale+	
sil	sil	
that	dh(sil,ae)b	ae(dh,td)	td(ae,hh)e	
hang	hh(td,ae)b	ae(hh,ng)	ng(ae,sil)e	
[begin_noise]	sil	
in(2)	ix(sil,n)b	n(ix,t)e	
tall	t(n,ao)b	ao	l(ao,sil)e	
[end_noise]	sil	
/t	t	
r(/r/)	r(t,iy)	
iy(/iy/)	iy(r,t)e	
t(/t/)	t	
aa(/aa/)	aa(t,p)e	
p(/p/)	p	
s/	s(p,sil)e	
[noise]	sil	
[noise](+noise+)	+noise+	
</s>	sile	
