<s>	silb	
sil	sil	
[noise](+noise+)	+noise+	
/m	m	
ih(/ih/)	ih(m,n)	
n(/n/)	n(ih,iy)e	
iy/	iy(n,p)s	
plants	p(iy,l)b	l(p,ae)	ae(l,n)	n	ts(n,ae)e	
and	ae(ts,n)b	n(ae,dd)	dd(n,ae)e	
animals	ae(dd,n)b	n(ae,ax)	ax(n,m)	m(ax,ax)	ax(m,l)	l(ax,z)	z(l,l)e	
live(2)	l(z,ih)b	ih(l,v)	v(ih,sil)e	
sil	sil	
in(2)	ix(sil,n)b	n(ix,dh)e	
the	dh(n,ah)b	ah(dh,sil)e	
sil	sil	
[human_noise](+inhale+)	+inhale+	
sil	sil	
/ow	ow(sil,sh)s	
sh(/sh/)	sh	
ix(/ix/)	ix	
n/	n(ix,sil)e	
[sil]	sil	
</s>	sile	
