<s>	silb	
[noise](+noise+)	+noise+	
the	dh(sil,ah)b	ah(dh,m)e	
mother	m(ah,ah)b	ah(m,dh)	dh(ah,axr)	axr(dh,sil)e	
[begin_noise]	sil	
/b	b	
ah(/ah/)	ah	
dh(/dh/)	dh(ah,axr)	
er	axr(dh,f)e	
f(/f/)	f	
l(/l/)	l(f,ay)	
ay/	ay(l,sil)s	
[end_noise]	sil	
lays	l(sil,ey)b	ey(l,z)	z(ey,sil)e	
[begin_noise]	sil	
tiny	t(sil,ay)b	ay(t,n)	n	iy(n,sil)e	
[end_noise]	sil	
eggs	eh(sil,g)b	g(eh,z)	z(g,sil)e	
[begin_noise]	sil	
on	aa(sil,n)b	n(aa,sil)e	
[end_noise]	sil	
her(2)	hh(sil,er)b	er(hh,l)e	
leaf	l(er,iy)b	iy	f(iy,sil)e	
[sil]	sil	
[noise]	sil	
</s>	sile	
