<s>	silb	
[noise]	sil	
a(2)	ey(sil,sil)s	
[begin_noise]	sil	
scientist	s(sil,ay)b	ay	ax(ay,n)	n(ax,t)	t(n,ix)	ix(t,s)	s(ix,td)	td(s,w)e	
walked	w(td,ao)b	ao	kd	td(kd,sil)e	
[end_noise]	sil	
through	th(sil,r)b	r(th,uw)	uw(r,ey)e	
a(2)	ey(uw,f)s	
field	f(ey,iy)b	iy(f,l)	l(iy,dd)	dd(l,sil)e	
[sil]	sil	
[noise](+noise+)	+noise+	
/w	w	
ah	aa	
td/	td	
is(2)	ix(td,z)b	z(ix,ix)e	
it(2)	ix(z,td)b	td(ix,d)e	
doing	d(td,uw)b	uw(d,ix)	ix(uw,ng)	ng(ix,sil)e	
sil	sil	
[noise]	sil	
sil	sil	
</s>	sile	
