<s>	silb	
[noise](+smack+)	+smack+	
sil	sil	
the	dh(sil,ah)b	ah(dh,f)e	
/f	f(ah,er)e	
er(/er/)	er(f,s)e	
s/	s(er,th)e	
thing	th(s,ih)b	ih(th,ng)	ng(ih,ey)e	
a(2)	ey(ng,k)s	
caterpillar	k(ey,ae)b	ae(k,dx)	dx(ae,ax)	ax(dx,p)	p(ax,ih)	ih	l	axr(l,iy)e	
eats	iy	ts(iy,ix)e	
is(2)	ix(ts,z)b	z(ix,ix)e	
its(2)	ix(z,ts)b	ts(ix,ow)e	
own	ow(ts,n)b	n(ow,sil)e	
sil	sil	
[noise](+exhale+)	+exhale+	
sil	sil	
eggshell	eh(sil,g)b	g	sh	eh	l(eh,sil)e	
sil	sil	
</s>	sile	
