<s>	silb	
[noise]	sil	
if(2)	ix(sil,f)b	f(ix,ax)e	
a	ax(f,r)s	
river	r(ax,ih)b	ih(r,v)	v(ih,axr)	axr(v,sil)e	
sil	sil	
/g	g	
eh/	eh	
sil	sil	
gets	g(sil,eh)b	eh(g,ts)	ts(eh,t)e	
too	t(ts,uw)b	uw(t,d)e	
deep	d(uw,iy)b	iy	pd(iy,sil)e	
sil	sil	
/w	w	
ao(/ao/)	ao	
er/	er	
sil	sil	
goes	g(sil,ow)b	ow(g,z)	z(ow,sil)e	
[begin_noise]	sil	
in(2)	ix(sil,n)b	n(ix,sil)e	
[end_noise]	sil	
on	aa(sil,n)b	n(aa,sil)e	
sil	sil	
[human_noise](+inhale+)	+inhale+	
sil	sil	
/ih	ih	
n(/n/)	n(ih,t)e	
t(/t/)	t(n,uw)	
uw/	uw(t,dh)e	
the(2)	dh(uw,ax)b	ax(dh,l)e	
land	l(ax,ae)b	ae(l,n)	n(ae,dd)	dd(n,sil)e	
[sil]	sil	
</s>	sile	
