<s>	silb	
if(2)	ix(sil,f)b	f(ix,ey)e	
a(2)	ey(f,sil)s	
[begin_noise]	sil	
lightning	l(sil,ay)b	ay	t	n	ix(n,ng)	ng(ix,s)e	
storm	s(ng,t)b	t(s,ao)	ao(t,r)	r(ao,m)	m(r,k)e	
/k	k	
ah(/ah/)	ah(k,m)	
m(/m/)	m(ah,s)e	
s/	s	
sil	sil	
comes	k(sil,ah)b	ah(k,m)	m(ah,z)	z(m,sil)e	
[end_noise]	sil	
[human_noise](+inhale+)	+inhale+	
sil	sil	
there	dh(sil,eh)b	eh(dh,r)	r(eh,aa)e	
are	aa(r,r)b	r(aa,f)e	
four	f(r,ao)b	ao(f,r)	r(ao,th)e	
things	th(r,ih)b	ih(th,ng)	ng(ih,z)	z(ng,y)e	
you	y(z,uw)b	uw(y,k)e	
can	k(uw,ae)b	ae(k,n)	n(ae,d)e	
do	d(n,uw)b	uw(d,t)e	
to	t(uw,ax)b	ax(t,s)e	
stay	s(ax,t)b	t(s,ey)	ey(t,s)e	
safe	s(ey,ey)b	ey(s,f)	f(ey,sil)e	
[sil]	sil	
</s>	sile	
