<s>	silb	
sil	sil	
in	ih(sil,n)b	n(ih,sil)e	
[begin_noise]	sil	
/k	k	
ae(/ae/)	ae(k,l)	
l(/l/)	l(ae,ah)e	
ah(/ah/)	ah	
f(/f/)	f(ah,ao)e	
ao(/ao/)	ao(f,r)	
r(/r/)	r(ao,y)e	
y(/y/)	y	
ah/	ah	
[end_noise]	sil	
[begin_noise]	sil	
people	p(sil,iy)b	iy(p,p)	p(iy,ax)	ax(p,l)	l(ax,sil)e	
[end_noise]	sil	
[human_noise]	sil	
are	aa(sil,r)b	r(aa,w)e	
working	w(r,er)b	er(w,k)	k(er,ix)	ix(k,ng)	ng(ix,t)e	
to(2)	t	ix(t,k)	
keep	k(ix,iy)b	iy(k,pd)	pd(iy,sil)e	
sil	sil	
seal	s(sil,iy)b	iy	l(iy,sil)e	
sil	sil	
homes	hh(sil,ow)b	ow(hh,m)	m	z(m,k)e	
clean	k(z,l)b	l(k,iy)	iy(l,n)	n(iy,ax)e	
and(2)	ax(n,n)b	n(ax,dd)	dd(n,s)e	
safe	s(dd,ey)b	ey(s,f)	f(ey,sil)e	
sil	sil	
[crosstalk](+noise+)	+noise+	
</s>	sile	
