<s>	silb	
[noise](+smack+)	+smack+	
sil	sil	
the(2)	dh(sil,ax)b	ax(dh,s)e	
storms	s(ax,t)b	t(s,ao)	ao(t,r)	r(ao,m)	m	z(m,hh)e	
/hh	hh	
ae(/ae/)	ae	
bd/	bd(ae,sil)e	
[begin_noise]	sil	
big	b(sil,ih)b	ih(b,gd)	gd(ih,sil)e	
[end_noise]	sil	
/w/	w	
[begin_noise]	sil	
/w	w	
ih(/ih/)	ih	
sil	sil	
n(/n/)	n	
s/	s(n,sil)e	
[end_noise]	sil	
[sil]	sil	
</s>	sile	
