<s>	silb	
[noise](+noise+)	+noise+	
now	n(sil,aw)b	aw(n,sil)e	
sil	sil	
[human_noise](+noise+)	+noise+	
[begin_noise]	sil	
storms	s(sil,t)b	t(s,ao)	ao(t,r)	r(ao,m)	m	z(m,ih)e	
in	ih(z,n)b	n(ih,dh)e	
the(2)	dh(n,ax)b	ax(dh,s)e	
spring	s(ax,p)b	p(s,r)	r(p,ih)	ih(r,ng)	ng(ih,sil)e	
[end_noise]	sil	
[human_noise](+exhale+)	+exhale+	
can	k(sil,ae)b	ae(k,n)	n(ae,b)e	
bring	b(n,r)b	r(b,ih)	ih(r,ng)	ng(ih,l)e	
/l	l	
ay	ay(l,sil)s	
sil	sil	
n(/n/)	n	
ih(/ih/)	ih	
ng/	ng(ih,sil)e	
[sil]	sil	
</s>	sile	
