<s>	silb	
[noise]	sil	
but(2)	b(sil,ax)b	ax(b,td)	td(ax,t)e	
turned	t(td,er)b	er(t,n)	n	dd(n,sil)e	
[begin_noise]	sil	
/ah	ah	
p(/p/)	p	
s(/s/)	s(p,ay)e	
ay	ay(s,dd)	
dd/	dd(ay,sil)e	
[end_noise]	sil	
down	d(sil,aw)b	aw(d,n)	n(aw,sil)e	
sil	sil	
its(2)	ix(sil,ts)b	ts(ix,k)e	
colors	k(ts,ah)b	ah(k,l)	l	axr(l,z)	z(axr,aa)e	
are	aa(z,r)b	r(aa,b)e	
brown	b(r,r)b	r(b,aw)	aw(r,n)	n(aw,sil)e	
sil	sil	
black	b(sil,l)b	l(b,ae)	ae	kd(ae,sil)e	
sil	sil	
pale	p(sil,ey)b	ey(p,l)	l(ey,y)e	
yellow	y(l,eh)b	eh	l(eh,ow)	ow(l,sil)e	
sil	sil	
or(2)	axr	
white(2)	w(axr,ay)b	ay	td(ay,sil)e	
</s>	sile	
