<s>	silb	
sil	sil	
[noise]	sil	
the	dh(sil,ah)b	ah(dh,f)e	
first	f(ah,er)b	er(f,s)	s(er,td)	td(s,th)e	
thing	th(td,ih)b	ih(th,ng)	ng(ih,dh)e	
the(2)	dh(ng,ax)b	ax(dh,k)e	
/k	k	
[noise](+rustle+)	+rustle+	
dx(/dx/)	dx	
axr(/axr/)	axr(dx,p)e	
p	p(axr,iy)b	iy(p,ih)e	
ih(/ih/)	ih	
l(/l/)	l(ih,axr)e	
axr/	axr(l,iy)e	
eats	iy	ts(iy,sil)e	
sil	sil	
is(2)	ix(sil,z)b	z(ix,ih)e	
its	ih(z,ts)b	ts(ih,sil)e	
sil	sil	
own	ow(sil,n)b	n(ow,eh)e	
eggshell	eh(n,g)b	g	sh	eh	l(eh,sil)e	
</s>	sile	
