<s>	silb	
sil	sil	
[noise](+exhale+)	+exhale+	
they	dh(sil,ey)b	ey(dh,w)e	
/w	w	
[noise](+rustle+)	+rustle+	
n(/n/)	n	
td/	td(n,t)e	
to(3)	t(td,uw)b	uw(t,hh)e	
help	hh(uw,eh)b	eh(hh,l)	l(eh,pd)	pd(l,sil)e	
sil	sil	
rwandans	r	ax	w(ax,aa)	aa(w,n)	n	d(n,ax)	ax(d,n)	n(ax,z)	z(n,sil)e	
sil	sil	
[noise](+inhale+)	+inhale+	
get(2)	g(sil,ih)b	ih	td(ih,sil)e	
sil	sil	
well	w(sil,eh)b	eh(w,l)	l(eh,ae)e	
and	ae(l,n)b	n(ae,dd)	dd(n,r)e	
return	r(dd,ix)b	ix(r,t)	t(ix,er)	er(t,n)	n(er,t)e	
to	t(n,ax)b	ax(t,dh)e	
their	dh(ax,eh)b	eh(dh,r)	r(eh,hh)e	
homes	hh(r,ow)b	ow(hh,m)	m	z(m,sil)e	
</s>	sile	
