<s>	silb	
[noise](+rustle+)	+rustle+	
sil	sil	
/m	m	
ah(/ah/)	ah	
k(/k/)	k	
ao(/ao/)	ao	
s	eh(ao,s)b	s(eh,sil)e	
sil	sil	
th/	th	
[human_noise]	sil	
are	aa(sil,r)b	r(aa,b)e	
/b	b	
er(/er/)	er	
d(/d/)	d	
sil	sil	
s/	s	
that	dh(s,ae)b	ae(dh,td)	td(ae,sil)e	
sil	sil	
look	l(sil,uh)b	uh(l,kd)	kd(uh,l)e	
like	l(kd,ay)b	ay(l,kd)	kd(ay,p)e	
/p	p	
eh	eh(p,r)	
r(/r/)	r(eh,ih)e	
ih(/ih/)	ih	
sil	sil	
ts/	ts	
[noise](+exhale+)	+exhale+	
</s>	sile	
