<s>	silb	
[noise](+inhale+)	+inhale+	
sil	sil	
the(2)	dh(sil,ax)b	ax(dh,m)e	
/m	m(ax,eh)e	
eh	eh	
d(/d/)	d	
ah	aa	
s(/s/)	s	
ih(/ih/)	ih(s,n)	
n(/n/)	n(ih,sil)e	
ts/	ts(n,k)e	
could	k(ts,uh)b	uh(k,dd)	dd(uh,hh)e	
help	hh(dd,eh)b	eh(hh,l)	l(eh,pd)	pd(l,sil)e	
sil	sil	
[human_noise](+noise+)	+noise+	
sil	sil	
make	m(sil,ey)b	ey(m,kd)	kd(ey,sil)e	
sil	sil	
[sil]	sil	
sick	s(sil,ih)b	ih	kd(ih,p)e	
people	p(kd,iy)b	iy(p,p)	p(iy,ax)	ax(p,l)	l(ax,f)e	
feel	f(l,iy)b	iy(f,l)	l(iy,b)e	
better	b(l,eh)b	eh(b,dx)	dx(eh,axr)	axr(dx,sil)e	
[sil]	sil	
</s>	sile	
