<s>	silb	
[noise]	sil	
they	dh(sil,ey)b	ey(dh,sil)e	
[begin_noise]	sil	
blow	b(sil,l)b	l(b,ow)	ow(l,sil)e	
[end_noise]	sil	
a	ax(sil,l)s	
long	l(ax,ao)b	ao(l,ng)	ng(ao,sil)e	
[human_noise](+inhale+)	+inhale+	
sil	sil	
thin	th(sil,ih)b	ih(th,n)	n(ih,k)e	
cloud	k(n,l)b	l	aw(l,dd)	dd(aw,sil)e	
sil	sil	
down	d(sil,aw)b	aw(d,n)	n(aw,sil)e	
sil	sil	
to(3)	t(sil,uw)b	uw(t,dh)e	
the	dh(uw,ah)b	ah(dh,sil)e	
[human_noise]	sil	
ground	g(sil,r)b	r(g,aw)	aw(r,n)	n(aw,dd)	dd(n,sil)e	
[noise](+smack+)	+smack+	
</s>	sile	
