<s>	silb	
sil	sil	
[noise](+inhale+)	+inhale+	
now	n(sil,aw)b	aw(n,p)e	
people	p(aw,iy)b	iy(p,p)	p(iy,ax)	ax(p,l)	l(ax,f)e	
from(2)	f(l,r)b	r(f,ah)	ah(r,m)	m(ah,ah)e	
other	ah(m,dh)b	dh(ah,axr)	axr(dh,sil)e	
sil	sil	
/k	k	
aa(/aa/)	aa	
ah(/ah/)	ah	
n(/n/)	n(ah,t)e	
t(/t/)	t(n,r)	
r(/r/)	r(t,iy)	
iy(/iy/)	iy(r,z)e	
z/	z(iy,sil)e	
sil	sil	
have	hh(sil,ae)b	ae(hh,v)	v(ae,g)e	
gone	g(v,ao)b	ao(g,n)	n(ao,t)e	
to(3)	t(n,uw)b	uw(t,ae)e	
africa(2)	ae(uw,f)b	f(ae,r)	r(f,ix)	ix(r,k)	k(ix,ax)	ax(k,sil)e	
sil	sil	
[noise](+smack+)	+smack+	
sil	sil	
</s>	sile	
