<s>	silb	
[noise]	sil	
[begin_noise]	sil	
stay	s(sil,t)b	t(s,ey)	ey(t,sil)e	
[end_noise]	sil	
away	ax(sil,w)b	w(ax,ey)	ey(w,sil)e	
sil	sil	
from	f(sil,axr)b	axr(f,m)	m	
the	dh(m,ah)b	ah(dh,l)e	
/l	l(ah,ay)e	
ay	ay(l,sil)s	
sil	sil	
t(/t/)	t	
ax(/ax/)	ax(t,n)e	
n(/n/)	n(ax,ih)e	
ih(/ih/)	ih	
ng/	ng(ih,sil)e	
sil	sil	
[sil]	sil	
</s>	sile	
