<s>	silb	
many	m(sil,eh)b	eh(m,n)	n(eh,iy)	iy(n,sil)e	
[begin_noise]	sil	
plants	p(sil,l)b	l(p,ae)	ae(l,n)	n	ts(n,sil)e	
[end_noise]	sil	
and(2)	ax(sil,n)b	n(ax,dd)	dd(n,ae)e	
animals	ae(dd,n)b	n(ae,ax)	ax(n,m)	m(ax,ax)	ax(m,l)	l(ax,z)	z(l,sil)e	
sil	sil	
live(2)	l(sil,ih)b	ih(l,v)	v(ih,ix)e	
in(2)	ix(v,n)b	n(ix,d)e	
/d	d(n,ax)	
ax/	ax	
/ow	ow(ax,sh)s	
sh(/sh/)	sh	
sil	sil	
ih(/ih/)	ih	
n(/n/)	n(ih,z)e	
z/	z(n,sil)e	
sil	sil	
[noise](+rustle+)	+rustle+	
</s>	sile	
