<s>	silb	
[noise](+inhale+)	+inhale+	
sil	sil	
they	dh(sil,ey)b	ey(dh,y)e	
use(2)	y(ey,uw)b	uw(y,z)	z(uw,f)e	
forest(2)	f(z,ao)b	ao(f,r)	r(ao,ix)	ix(r,s)	s(ix,td)	td(s,sil)e	
[human_noise](+inhale+)	+inhale+	
[begin_noise]	sil	
plants	p(sil,l)b	l(p,ae)	ae(l,n)	n	ts(n,sil)e	
[end_noise]	sil	
to(2)	t	ix	
make	m(ix,ey)b	ey(m,kd)	kd(ey,sil)e	
sil	sil	
/m	m	
eh	eh	
d(/d/)	d(eh,ax)	
ax(/ax/)	ax(d,s)	
s(/s/)	s(ax,ih)e	
ih(/ih/)	ih(s,n)	
n/	n(ih,sil)e	
sil	sil	
[human_noise](+exhale+)	+exhale+	
sil	sil	
[noise](+smack+)	+smack+	
sil	sil	
</s>	sile	
