<s>	silb	
sil	sil	
they	dh(sil,ey)b	ey(dh,k)e	
kept(2)	k(ey,eh)b	eh	pd(eh,td)	td(pd,ax)e	
a	ax(td,f)s	
few	f(ax,y)b	y(f,uw)	uw(y,b)e	
butterflies	b(uw,ah)b	ah(b,dx)	dx(ah,axr)	axr	f	l(f,ay)	ay(l,z)	z(ay,ix)e	
in(2)	ix(z,n)b	n(ix,k)e	
/k	k	
ey(/ey/)	ey(k,sil)e	
sil	sil	
j	jh(sil,ey)b	ey(jh,ix)e	
ix(/ix/)	ix	
s/	s(ix,sil)e	
[begin_noise]	sil	
to(3)	t(sil,uw)b	uw(t,l)e	
lay	l(uw,ey)b	ey(l,sil)e	
[end_noise]	sil	
more	m(sil,ao)b	ao(m,r)	r(ao,eh)e	
eggs	eh(r,g)b	g(eh,z)	z(g,sil)e	
</s>	sile	
