<s>	silb	
they	dh(sil,ey)b	ey(dh,k)e	
/k	k	
ae(/ae/)	ae	
p/	p	
sil	sil	
a(2)	ey(sil,sil)s	
sil	sil	
[noise](+inhale+)	+inhale+	
sil	sil	
few	f(sil,y)b	y(f,uw)	uw(y,b)e	
/b	b	
ah(/ah/)	ah(b,t)	
t(/t/)	t	
axr(/axr/)	axr(t,f)e	
f(/f/)	f	
l(/l/)	l(f,ay)	
ay	ay(l,z)s	
z/	z(ay,ix)e	
in(2)	ix(z,n)b	n(ix,dh)e	
the(2)	dh(n,ax)b	ax(dh,k)e	
cage	k(ax,ey)b	ey	jh	
to	t(jh,ax)b	ax(t,l)e	
lay	l(ax,ey)b	ey(l,sil)e	
[noise]	sil	
more	m(sil,ao)b	ao(m,r)	r(ao,sil)e	
sil	sil	
eggs	eh(sil,g)b	g(eh,z)	z(g,sil)e	
[noise]	sil	
</s>	sile	
